NO ./texture/walls/north_wall_texture.xpm
SO ./texture/walls/south_wall_texture.xpm
WE ./texture/walls/west_wall_texture.xpm
EA ./texture/walls/east_wall_texture.xpm
F 125,100,70
C 225,30,0

111111111111111111111111111111111111
100000001000000000000000000000111111
1000000011110100000000000000111
10000000100000000000000000000ND1111
100000001000000100000000000000000001
100000000000000001000000000000000001
100000001000000101000000000000000001
100000001000000101000000000000000001
111111111111111 11111111111111111111