NO ./texture/walls/north_wall_texture.xpm
SO ./texture/walls/south_wall_texture.xpm
WE ./texture/walls/west_wall_texture.xpm
EA ./texture/walls/east_wall_texture.xpm
F 125,100,70
C 225,30,0

111111111111111111111111111111111111
100000001000000000000000000000111111
10000000111101000000E0000000111
10000000100000000000000000000011111
100000001000000100000001000000000001
10000000D000000001000000D00000D00001
10000000100000010100000D00D0000D0001
1000000010000001D1000000D00D00000001
111111111111111 11111111111111111111
