NO ./texture/walls/north_wall_texture.xpm
SO ./texture/walls/south_wall_texture.xpm
WE ./texture/walls/west_wall_texture.xpm
EA ./texture/walls/east_wall_texture.xpm
F 125,100,70
C 225,30,0

111111111111111111111111111111111111
100000001000000000000000000000111111
100000001111D10000000000000011
10000000100000000000000000000001111
100000001000000N00000000000000000001
10000000D0000000000000000000D0000001
100000001000000000000000000000000001
100000001000000000000000000000000001
111111111111111111111111111111111111