NO ./texture/walls/north_wall_texture.xpm
SO ./texture/walls/south_wall_texture.xpm
WE ./texture/walls/west_wall_texture.xpm
EA ./texture/walls/east_wall_texture.xpm
F 220,100,0
C 225,30,0

11111
10001
100N1
10001
11110