NO ./path_to_the_north_texture
F 220,100,0
SO ./path_to_the_south_texture
WE ./path_to_the_west_texture
EA ./path_to_the_east_texture

C 225,30,0

1111

1
111111111
111
	
        
1111111
11111
000000000001