WE ./texture/walls/west_wall_texture.xpm
SO			./texture/walls/south_wall_texture.xpm                 
NO ./texture/walls/north_wall_texture.xpm
EA ./texture/walls/east_wall_texture.xpm


F 220,100,0
C 225,30,0	             

11111111111111111111111111111
10000000000000000000000000001
10000000000000000000000100001
10000000000000000000000000001
10000000000000000000000000001
100000000001111100000000000001
10000000000010001000000000001
10000000001111110000000000001
10000000000000000000001N1000111111
100000000010000000000001000011111       
10000000000000000000000000001       
11111111000000000000000000001      
       10000000000001111111111  1111	
	   1111111111111111111111111111111     
1111111111111111111111111111111111111111	