NO ./path_to_the_north_texture
SO ./path_to_the_south_texture





WE ./path_to_the_west_texture
EA ./path_to_the_east_texture

C 225,30,0
F 220,100,0

11111111111111111111111111111
10000000000000000000000000001
10000000000000000000000100001
10000000000000000000000000001
10000000000000000000000000001
100000000001111100000000000001
10000000000010001000000000001
10000000001111110000000000001
1000000000000000000000000000111111
100000000000000000000000000011111
1000000000S000000000000000001
11111111000000000000000000001
		10000000000001111111111111111111111111
1111111111111111111111111111111111111111