NO ./texture/walls/north_wall_texture.xpm
SO ./texture/walls/south_wall_texture.xpm
WE ./texture/walls/west_wall_texture.xpm
EA ./texture/walls/east_wall_texture.xpm
F 220,100,0
C 225,30,0

    11111111
    10000001
111110N00001
100000000001
111111111111